00000000000000000000000000000
00000010000000000000001000000
00000010000000100000001000000
00111111100111111100111111100
00000000000000100000000000000
10000000000000100000000000001
11100001111110001111110001111
00000000000000000000000000000
00000000000000000000000000000
00111111100111111100111111100
00000000000000100000000000000
00000000000000000000000000000
10000000111100000111100000001
10000000000000000000000000001
11110000000000100000000001111
10000000000011111000000000001
10000001000000000000010000001
10000001000000000000010000001
11111111111111111111111111111
